EMP = "countries/The Empire.txt"
ERI = "countries/Eriadu Authority.txt"
SID = "countries/Sidious.txt"
IBC = "countries/Intergalactic Banking Clan.txt"
SFS = "countries/Sienar Fleet Systems.txt"
TAG = "countries/TaggeCo.txt"
FAL = "countries/Falleen.txt"
MIT = "countries/House Mitth.txt"
RIN = "countries/Rintonne.txt"
REB = "countries/The Rebellion.txt"
DAT = "countries/Dathomir.txt"
INR = "countries/House Inrokini.txt"
BLA = "countries/Black Sun.txt"
ABR = "countries/Abregado-rae.txt"
ZYG = "countries/Zygerria.txt"
JHT = "countries/Jabba.txt"
ZAN = "countries/Zann Consortium.txt"
PYK = "countries/Pyke Syndicate.txt"
HAP = "countries/Hapes Consortium.txt"
FTU = "countries/Federated Teradoc Union.txt"
BAK = "countries/Bakura.txt"
BES = "countries/Bespin.txt"
CHA = "countries/Chandrila.txt"
MAL = "countries/Malastare.txt"
BOT = "countries/Bothawui.txt"
ZER = "countries/Zero Command.txt"
REN = "countries/Rendili.txt"
COR = "countries/Corellia.txt"
MAA = "countries/Manaan.txt"
BET = "countries/Bestine.txt"
MIM = "countries/Mimban.txt"
BYS = "countries/Byss.txt"
VON = "countries/Yuuzhan Vong.txt"
KOR = "countries/Korriban.txt"
FON = "countries/Fondor.txt"
FRE = "countries/Fresia.txt"
KYK = "countries/Kashyyyk.txt"
KUA = "countries/Kuat.txt"
SSI = "countries/Ssi-ruuvi Imperium.txt"
MAN = "countries/Mandalore.txt"
CAL = "countries/Mon Calamari.txt"
NAB = "countries/Naboo.txt"
PAN = "countries/Pantora.txt"
RYL = "countries/Ryloth.txt"
FEL = "countries/Felucia.txt"
SUL = "countries/Sullust.txt"
TAR = "countries/Taris.txt"
THY = "countries/Thyferra.txt"
CHS = "countries/Chiss Ascendancy.txt"
OND = "countries/Onderon.txt"
TRA = "countries/Trandosha.txt"
RHA = "countries/Sorcerers of Rhand.txt"
SER = "countries/Serreno.txt"
AUT = "countries/Corporate Sector Authority.txt"
COM = "countries/COMPNOR.txt"
EOH = "countries/Empire of the Hand.txt"
ICO = "countries/Imperial Oversector.txt"
MUS = "countries/Mustafar.txt"
REE = "countries/Restored Empire.txt"
ZSJ = "countries/Zsinj's Empire.txt"
WAY = "countries/Wayland.txt"
TUN = "countries/Sorcerers of Tund.txt"
ROD = "countries/Rodia.txt"
HUT = "countries/Hutt Grand Council.txt"
CAT = "countries/Catonica.txt"
PEN = "countries/Pentastar Alignment.txt"
PRO = "countries/Mandalorian Protectors.txt"
AWA = "countries/Clan Awaud.txt"
ELD = "countries/Clan Eldar.txt"
ROK = "countries/Clan Rook.txt"
KRY = "countries/Clan Kryze.txt"
GMA = "countries/Greater Maldrood.txt"
SUN = "countries/Thyrsus.txt"
DUS = "countries/Duskhan League.txt"
ZAL = "countries/Zaltin Corporation.txt"
ASH = "countries/Ashern Cartel.txt"
KYY = "countries/Kashyyyk2.txt"
SOR = "countries/SoroSuub.txt"
CZE = "countries/Czerka Corporation.txt"
CYB = "countries/Cybot Galactica.txt"
IND = "countries/Industrial Automaton.txt"
CHI = "countries/Chiewab.txt"
MER = "countries/Merr Sonn.txt"
KFC = "countries/Karflo Corporation.txt"
AKT = "countries/Ayelixe Krongbing.txt"
ATH = "countries/Athakam Medtech.txt"
MEL = "countries/Millennium Entertainments.txt"
NEU = "countries/Neuro-Saav.txt"
INC = "countries/Incom Corporation.txt"
FTI = "countries/FreiTek Incorporated.txt"
UBK = "countries/Ubrikkian Industries.txt"
TRI = "countries/Trilon Inc.txt"
ARD = "countries/Ardees Beverage Company.txt"
SLK = "countries/Slayn and Korpil.txt"
ACU = "countries/AccuTronics.txt"
BAN = "countries/Bank of the Core.txt"
BLS = "countries/Blastech.txt"
ARA = "countries/Arakyd.txt"
KES = "countries/Kessel.txt"
SIN = "countries/Singing Mountain Clan.txt"
BIB = "countries/Biblos.txt"
ZEL = "countries/Zeltros.txt"
BIT = "countries/Bith.txt"
JAE = "countries/Jaemus.txt"
BEX = "countries/Bextar.txt"
ORD = "countries/Ord Trasi.txt"
JAW = "countries/The Jawas.txt"
TUS = "countries/The Tusken Raiders.txt"
ZAA = "countries/Zaarin Clique.txt"
CEC = "countries/Corellian Engineering Corporation.txt"
QAE = "countries/Qom Qae.txt"
ORC = "countries/Ord Cantrell.txt"
SAN = "countries/Santhe .txt"
HON = "countries/Honoghr.txt"
YAG = "countries/Yag'Dhul.txt"
SLU = "countries/Sluis Van.txt"
ALZ = "countries/Alzoc III.txt"
UTA = "countries/Utapau.txt"
KAR = "countries/Karazak.txt"
LOK = "countries/Lok.txt"
ROT = "countries/Rothana.txt"
HOS = "countries/Hosnian Prime.txt"
LTF = "countries/Tallaan.txt"
TAP = "countries/Tapani Federation.txt"
JED = "countries/Jedha.txt"
AAR = "countries/Aargau.txt"
SAL = "countries/Salliche.txt"
CAM = "countries/Caamas.txt"
CIR = "countries/Circumtore.txt"
TEL = "countries/Telos IV.txt"
TER = "countries/Terephon.txt"
REL = "countries/Relephon.txt"
DAL = "countries/The Maw Irregular Fleet.txt"
TET = "countries/Empress Teta.txt"
PRA = "countries/Prakith.txt"
LIA = "countries/Santhe Corporation.txt"
NUB = "countries/Nubia.txt"
OSS = "countries/Ossus.txt"
JAB = "countries/Jabiim.txt"
GAU = "countries/Guavian Death Gang.txt"
SLE = "countries/Sleheyron.txt"
LOM = "countries/Lotho Minor.txt"
SLC = "countries/Saleucami.txt"
WHE = "countries/The Wheel.txt"
EAD = "countries/Eadu.txt"
GYN = "countries/Gyndine.txt"
ROC = "countries/Roche Industries.txt"
GUN = "countries/Gungans.txt"
BOR = "countries/Borleias.txt"
YUT = "countries/Yutrane-Trackata.txt"
KOE = "countries/Koensayr Manufacturing.txt"
NAG = "countries/Nagai .txt"
RPE = "countries/Republic Engineering Corporation.txt"
RIT = "countries/Free Rintonne.txt"
CIU = "countries/Cuitric Hegemony.txt"
ITH = "countries/Ithor.txt"
TAA = "countries/Taanab.txt"
MIR = "countries/Mirial.txt"
GRM = "countries/New Cov.txt"
ELM = "countries/Elom.txt"
MIN = "countries/Mindor.txt"